11111111
11000111
11100?11
11111111
